......x..x......x....x..........
......x..x..x...x....x..........
......x.....x...x....x..........
......x.....x........x..........
......x..x..x...x....x..........
......x..x..x...x....x..........
......x..x......x....x..........
......x..xxxxxxxx....x..........
......x..x...........x..........
......x..x...........x..........
......x..x...xxxxxxxxx..........
......x..x...x..................
......x..x...x..................
......x..x...x.................e
......x..x...x..................
......x..x...x..................
......x..x...x..................
......x..x...x..................
......x..x...x..................
......x..x...x..................
......x..x...x..................
......x..x...x..................
......x..x...x..................
......x..x...x..................
.........x......................
......x..x...x..................
......x..x...x..................
......x..x...x..................
